###############
#.  #######  .#
# #         # #
# ##### ##### #
#             #
# ## ##### ## #
# ## # f # ## #
# ## ##### ## #
#      @      #
# ##### ##### #
# #         # #
#.  #######  .#
###############